00000000111111111111
01111100000000000000
01000000000000000000
01111100000000000000
00000000000000000000
00000000000000000000
00000000000000000000
00000000000000000000
00000000000000000000
00000000000000000000
00000000000000000000
00000000000000000000
00000000000111100000
00000000000000000000
00000000000000000000
